t,t,t,t,t,t,t,t,t,t,t,t,t,t,t,t,t,t,t,t
t, , , , , , , , , , , , , , , , , , ,t
t, ,p, , , , , , , , , , , , , , , , ,t
t, , ,t, , , , , , ,t,t,t,t, , , , , ,t
t, , ,t, , , , , , , , , ,t, , , , , ,t
t, , ,t,t,t,t,t, , , , , ,t, , , , , ,t
t, , ,t, , , , , , , , , ,t, , , , , ,t
t, , ,t, , , ,t, , , , , ,t, , , , , ,t
t, , ,t, , , ,t, , , , , ,t, , , , , ,t
t, , ,t, , , ,t, , , , , ,t, , , , , ,t
t, , ,t, , , , , , , , , ,t, , , , , ,t
t, , ,t, , , , , , , , , ,t,t,t, , , ,t
t, , , , , , ,t, ,t, , , , , , , , , ,t
t, , , , , ,t,t,t,t,t, , , , , , , , ,t
t, , , , , , ,t,t,t, , , , , , , , , ,t
t, , , , , , , ,t, , , , , , , , , , ,t
t, , , , , , , , , , , , , , , , , , ,t
t, , , , , , , , , , , , , , , , , , ,t
t, , , , , , , , , , , , , , , , , , ,t
t,t,t,t,t,t,t,t,t,t,t,t,t,t,t,t,t,t,t,t